############
#        OO##
#          #
#   P   ####
#          #
#######    #
#  O ##    #
#  O ##    #
#          #
#   XX  XX #
#       #  #
############
