########
#OXP   #
# X    #
# O    #
#      #
########
